
C 225,30,0

NO ./textures/Brick_Wall.xpm
WE ./textures/Grass.xpm

EA ./textures/Magma_Floor.xpm

SO ./textures/Wooden_Floor_Horizontal.xpm

F 220,100,0


        1111111111111111111111111
        1000000000110000000000001
        1011000001110000000000001
        1001000000000000000000001
111111111111111111111111111111111
 
 
111111111111111111111
10000000001100000111011111111111
11111111111111111111011111111
11110111111111011100001110001
11110111111111011101010000001
11000000110101011100000010001
10000000000000001100000010001
10000000000000001101010010001
11000001110101011111011110N0111
11110111 1110101 101111010001
11111111 1111111 111111111111
